"allele","unst_N_fam","unst_fr_fam","unst_mat","unst_pat","unst_mult_ind","unst_high_conf","N_offspring","N_families"
"Iex2_0003",19,0.730769230769231,5,14,18,19,104,26
"Iex2_0004",1,0.0263157894736842,0,1,1,1,324,38
"Iex2_0006",1,0.125,0,1,1,0,17,8
"Iex2_0008",5,0.384615384615385,2,3,2,3,53,13
"Iex2_0010",1,0.25,0,1,1,0,12,4
"Iex2_0012",14,0.777777777777778,6,8,13,14,58,18
"Iex2_0016",1,0.111111111111111,0,1,1,1,51,9
"Iex2_0053",1,0.25,1,0,0,1,15,4
"Iex2_0054",1,0.0909090909090909,1,0,0,1,31,11
"Iex2_0072",1,0.0666666666666667,0,1,0,0,52,15
"Iex2_0093",1,1,1,0,1,1,1,1
"Iex2_0109",1,0.5,0,1,0,0,12,2
"Iex2_0111",1,0.333333333333333,1,0,0,1,5,3
"Iex2_0167",6,0.857142857142857,3,3,4,6,15,7
"Iex2_0274",4,0.8,1,3,4,3,9,5
"Iex2_0306",5,0.625,2,3,4,4,21,8
"Iex2_0333",3,0.75,1,2,2,2,9,4
"Iex2_0384",1,0.125,1,0,0,1,24,8
"Iex2_0518",1,0.166666666666667,0,1,1,1,21,6
"Iex2_0534",1,0.5,1,0,1,1,2,2
"Iex2_0535",7,0.7,1,6,4,7,17,10
"Iex2_0669",1,1,0,1,1,1,2,1
"Iex2_1230",1,1,0,1,1,1,2,1
"Iex2_1237",1,0.5,0,1,0,0,2,2
"Iex2_1502",1,0.5,1,0,0,1,6,2
"Iex2_1504",2,0.666666666666667,0,2,1,1,8,3
"Iex2_1505",1,0.5,0,1,0,1,2,2
"Iex2_ps1",1,0.0526315789473684,1,0,1,1,99,19
"Iex2_ps5",1,1,0,1,0,1,1,1
"Iex2_ps6",2,0.666666666666667,0,2,1,1,5,3
"Iex3_004",1,0.032258064516129,0,1,0,0,181,31
"Iex3_012",3,0.125,0,3,1,2,123,24
"Iex3_013",3,0.125,2,1,1,2,137,24
"Iex3_015",1,0.05,0,1,1,1,77,20
"Iex3_018",1,0.0555555555555556,1,0,0,1,66,18
"Iex3_019",2,0.0833333333333333,1,1,0,1,122,24
"Iex3_029",1,0.111111111111111,0,1,1,0,51,9
"Iex3_044",1,0.111111111111111,0,1,0,0,52,9
"Iex3_048",1,0.0833333333333333,1,0,0,1,40,12
"Iex3_049",1,0.0666666666666667,0,1,0,1,51,15
"Iex3_057",1,0.25,0,1,1,0,12,4
"Iex3_058",1,0.2,0,1,1,0,29,5
"Iex3_060",2,0.4,0,2,2,2,34,5
"Iex3_068",1,0.125,0,1,1,0,17,8
"Iex3_070",1,0.111111111111111,0,1,0,0,49,9
"Iex3_072",4,0.5,1,3,2,3,41,8
"Iex3_087",1,0.0666666666666667,0,1,0,0,50,15
"Iex3_093",5,0.555555555555556,0,5,4,5,25,9
"Iex3_094",1,0.2,1,0,1,1,12,5
"Iex3_100",1,0.0769230769230769,0,1,0,0,63,13
"Iex3_109",7,0.583333333333333,0,7,7,6,31,12
"Iex3_112",1,0.166666666666667,1,0,1,1,19,6
"Iex3_116",1,0.333333333333333,0,1,0,0,18,3
"Iex3_126",2,0.285714285714286,0,2,1,2,18,7
"Iex3_128",1,0.25,0,1,1,1,9,4
"Iex3_132",5,0.833333333333333,0,5,4,4,9,6
"Iex3_133",4,0.666666666666667,0,4,3,4,14,6
"Iex3_135",6,0.857142857142857,0,6,4,5,22,7
"Iex3_136",6,0.75,0,6,5,5,17,8
"Iex3_138",2,0.5,1,1,2,2,19,4
"Iex3_139",4,0.666666666666667,0,4,3,4,11,6
"Iex3_142",4,0.666666666666667,0,4,2,3,17,6
"Iex3_146",5,0.833333333333333,0,5,2,4,12,6
"Iex3_149",5,0.833333333333333,0,5,4,4,16,6
"Iex3_150",1,0.333333333333333,0,1,1,1,12,3
"Iex3_152",4,1,0,4,3,4,7,4
"Iex3_154",4,1,0,4,4,3,9,4
"Iex3_157",1,1,0,1,0,1,1,1
"Iex3_158",4,0.8,0,4,2,3,10,5
"Iex3_159",1,0.5,0,1,1,1,4,2
"Iex3_160",2,1,0,2,2,2,4,2
"Iex3_161",4,0.8,0,4,4,3,17,5
"Iex3_162",2,0.666666666666667,0,2,2,1,6,3
"Iex3_163",3,1,0,3,3,3,5,3
"Iex3_164",1,1,0,1,1,1,2,1
"Iex3_166",1,0.5,0,1,1,1,4,2
"Iex3_168",1,1,0,1,1,0,2,1
"Iex3_169",2,1,0,2,2,2,5,2
"Iex3_173",1,0.5,0,1,1,1,2,2
"Iex3_188",6,0.24,4,2,2,6,133,25
"Iex3_189",1,0.25,0,1,0,0,13,4
"Iex3_192",4,0.8,1,3,4,3,23,5
"Iex3_193",6,0.666666666666667,2,4,4,5,28,9
"Iex3_194",3,0.75,0,3,2,2,8,4
"Iex3_202",5,0.555555555555556,0,5,4,5,24,9
"Iex3_205",1,0.5,1,0,1,1,2,2
"Iex3_206",2,1,0,2,1,2,3,2
"Iex3_209",1,0.2,0,1,0,0,23,5
"Iex3_210",3,0.75,2,1,2,3,28,4
"Iex3_213",3,1,0,3,3,3,3,3
"Iex3_216",1,1,0,1,1,1,1,1
